
NO textures/HITLER.png

SO textures/eagle.png

EA textures/brick.png

WE textures/hitlerflag.png

F 255,3,255

C 0,0,0


                       111111111111
                        10000000001
                        10000000001
                         100000001
1111111111111111111111111111000001
100000000000000000000000000000001
100111111110111111111111110000011
10001    110000000000000001111111
11011    11111111111111110111111111
10001111111000000000000000000000001
11111111111111111111111111111111111
111111111111111111111111111111111111111111111111111111111111111111
1000000001101               1000000000001000          100000000001
1000100001101               100000000000111111111110000000000001
100011111110111111          100000000000000000000000000000000001
100011000000000001          100000000000111111111110000000000001
100011000000000001          1000000000001          100000000001
10001100000000000111111111111000000000001           1000000001
10001100000100000000000000000000011111111            10000001
1000110000100000011111111111110001                    111111
100001000000000001           10001
1000000000N0000101           10001
100001000000000001           10001
100011000001000001           10001
100011000000000001          10001
100011000000000001         10001
100011000000000001        10001
100011111111111111       10001
10001            1111111000111
1001          11100000010001
101         110000000000001
101        10000000000000001
101       1000000000000000001
101111111100000000000000000001
100000000000000000000000000001
111111111100000000000000000001
          1000000000000000001
           10000000000000001
            110000000000011
              11100000111
                 11111