NO textures/HITLER.png

SO textures/eagle.png

EA textures/brick.png

WE textures/hitlerflag.png

F 255,3,255

C 0,0,0

1111111111111111111111111
1000000000110000000000001
1011000001110000000000001
100100000N000000000000001
1111111111111111111111111